111111111111111111111111111111111111
1ECP0000F011111111111111111111111111
111111111111111111111111111111111111