1111111111
100P0C0001
1100000001
10E000F001
1111111111