111111111111
10000000P111
110000000111
100000C00111
11111000E111
100000F00011
111111111111