111111111111
10000000P111
110000000111
100000C00111
111110001111
100000F000E1
111111111111