111111111111
100P0C000111
110000000111
10E000E00111
111111111111
10000F000001
111111111111