111111111111
100P0C000111
110000000111
10E000F00111
111111111111