1111111111111
100100000CC01
1000011111001
1P0011E000001
1100F000F0011
1100000000111
1111111111111