1111111111111
100100000CC01
1000011111001
1P0011E000001
1100000000011
1100000000011
11CCCCCCCCC11
11CCCCCCCCC11
11CCCCCCCCC11
1100000000011
1100000F00011
1111111111111